------------------------------
------------------------------
------------------------------
------------------------------
------------------------------
--------S---------XX----------
------------------XX----------
----------------X-XX----------
-------E-EE-----X-XX----------
-SS--------XX-X-X-XX----------
-----------XX-X-X-XX----------
-----------XX-X-X-XX----------
-----------X--X-X-XX----EE-E--
-XXXX------X--X-X-XXXXXXXXXXXX