-----------------------------
-----------------------------
-----------------------------
-----------------------------
-----------------------------
--S-------------------SS-----
-----------------------------
-----------------------------
-E-EE--------------SSS----oo-
-----XX-X--------------------
-----XX-XX-------------------
-----XX-XXX------------------
-----X--XXXX--X--------------
-----X--XXXXXXXXXXXXXXX-X----