--------------------------
--------------------------
--------------------------
--------------------------
--------------------------
--S------------QQQQ---QQQQ
--------------------------
--------------------------
-E-EE---------------------
-----XX-X----QQ?SSQQQQ?SSQ
-----XX-X-----------------
-----XX-X-----------------
-----X--X-----------------
-----X--X--XXXXX--XXXXX--X