------------------------------
------------------------------
------------------------------
------------------------------
------------------------------
--------E------SSSSSSSSSS-----
------------------------------
----------X-------------------
-o------EXX--SS---------------
-------<>XX-------------------
-------[]XX-------------------
------X[]XX-------------------
-----XX[]XX-------------------
---XXXXXXXXXXXXX----------XXXX