------------------------------
------------------------------
------------------------------
------------------------------
------------------------------
----------SSS-----SSSSSSSSSSS-
------------------------------
------------------------------
------------------------------
----------------XX------------
----------------XX------------
----------------XXX-----------
----E-----------XXX-----------
-XXXXX--XXXX-X--XXXXX---------