------------------------------
------------------------------
------------------------------
------------------------------
------------------------------
------------S---------S-------
------------------------------
------------------------------
--E--SS----E-EE------E-EE-----
-<>------------XX-X------XX-X-
-[]------------XX-X------XX-X-
-[]------------XX-X------XX-X-
-[]------------X--X------X--X-
-XXXXXXXX------X--X------X--X-