------------------------------
------------------------------
------------------------------
------------------------------
------------------------------
SS--------S-------------------
------------------------------
------------------------------
SS-------E-EE------------XSS-S
-------------XX-X-------XXX---
-------------XX-X------XXXX---
-------------XX-X-----XXXXX---
----X--------X--X----XXXXXX--S
--XXXXX------X--X--XXXXXXX----