------------------------------
------------------------------
------------------------------
------------------------------
------------------------------
--S-------------E----------SSS
------------------------------
------------------X-----------
-E-EE-----------EXX------SS---
-----XX-X------<>XX-----------
-----XX-X------[]XX-----------
-----XX-X-----X[]XX-----------
-----X--X----XX[]XX-----------
-----X--X--XXXXXXXXXX--XXXXX--