------------------------------
------------------------------
------------------------------
------------------------------
------------------------------
--S-------SSSSSS---SSSSSSS----
------------------------------
------------------------------
-E-EE-------------------------
-----XX-XX--------------------
-----XX-XX--------------------
-----XX-XXX-------------------
-----X--XXX-------------------
-----X--XXXXX----XXXX------X--