------------------------------
------------------------------
------------------------------
------------------------------
------------------------------
----SSS--------------------S--
------------------------------
------------------------------
--------------------------E-EE
-E-X-----------X-------X------
<>-X-----------X-------X------
[]-X-----------X-----X-X------
[]-X-----------X-----X-X------
XXXXXXXXX--XX--X--XX-X-X------