------------------------------
------------------------------
------------------------------
------------------------------
------------------------------
------E---XX-----S------------
---------XXX------------------
--------XXXX------------------
------EXXXXX----E-EE------o---
-----<>XXXXX--------XX-X-----X
-----[]XXXXX--------XX-X-----X
----X[]XXXXX--------XX-X-----X
---XX[]XXXXX--------X--X-----X
XXXXXXXXXXXXXX------X--X-----X