-----------------------------
-----------------------------
-----------------------------
-----------------------------
-----------------------------
-------E------SSSSSSS-----S--
-----------------------------
---------XX------------------
-------EXXX--------------E-EE
------<>XXX------------------
------[]XXX------------------
-----X[]XXX------------------
----XX[]XXX------------------
XXXXXXXXXX--XXXX------X------