------------------------------
------------------------------
------------------------------
------------------------------
------------------------------
SSS-----------SSSSSSSSS-------
-----------------------------E
----------------------------<>
SSS----S--------------------[]
-----------E----------------XX
-----------E------------------
------------------------------
------------------------------
---XXXXXXXXXXXXX--------XXXXXX