------------------------------
------------------------------
------------------------------
------------------------------
------------------------------
--S-------------E---XX--------
-------------------XXX-------X
------------------XXXX------XX
-E-EE-----------EXXXXX-----XXX
-----XX-X------<>XXXXX-----XXX
-----XX-X------[]XXXXX---XXXXX
-----XX-X-----X[]XXXXX--XXXXXX
-----X--X----XX[]XXXXX-----XXX
-----X--X--XXXXXXXXXXXXXXXXXXX