----------------------------
----------------------------
----------------------------
----------------------------
----------------------------
SS--SS-----S----------------
----------------------------
----------------------------
SS--------E-EE--------------
--------------XX-X----------
--------------XX-X----------
--------------XX-X----------
--------------X--X----------
--XXXXXX------X--X--XXX-----