------------------------------
------------------------------
------------------------------
------------------------------
------------------------------
SSSS-----S--------------------
------------------------------
------------------------------
SSSS----E-EE------------oo---o
------------XX-X----S---------
------------XX-X--------------
------------XX-X--------------
------------X--X--------------
----XX------X--X--XXXXX----X--