------------------------------
------------------------------
------------------------------
------------------------------
------------------------------
--S----------------XXX--SSSSSS
------------------XXXX--------
-----------------XXXXX--------
-E-EE-----------XXXXXX--------
-----XX-X-------XXXXXX--------
-----XX-X-----XXXXXXXX--------
-----XX-X----XXXXXXXXX--------
-----X--X-------XXXXXX--------
-----X--X--XXXXXXXXXXXXXXX----