------------------------------
------------------------------
------------------------------
------------------------------
------------------------------
--S---------S-------------E---
-----------------------------X
----------------------------XX
-E-EE------E-EE-----------EXXX
-----XX-X------XX-X------<>XXX
-----XX-X------XX-X------[]XXX
-----XX-X------XX-X-----X[]XXX
-----X--X------X--X----XX[]XXX
-----X--X------X--X--XXXXXXXXX