------------------------------
------------------------------
------------------------------
------------------------------
------------------------------
------------SSSS---SSSSSSS----
------------------------------
------------------------------
-oo---------------------------
------S-----------------------
----------E-------------------
---------<>-------------------
---------[]-------------------
----XXXXXXXXXX---XXXX------X--