------------------------------
------------------------------
------------------------------
------------------------------
------------------------------
-------------XX--SSSSSSSSS----
------------XXX---------------
-----------XXXX---------------
----------XXXXX---------------
----------XXXXX---------------
--------XXXXXXX---------------
-------XXXXXXXX---------------
----------XXXXX---------------
---X-XXXXXXXXXXXXXX--------XXX