----------------------------
----------------------------
----------------------------
----------------------------
----------------------------
-------S-----------------S--
----------------------------
---X-------------oo---------
---X--E-EE--------------E-EE
-X-X------XX-XXX------------
-X-X------XX-XXX------------
-X-X------XX-XXX------------
-X-X------X--XXX------------
-X-X------X--XX---XXXX------