-------------------------
-------------------------
-------------------------
-------------------------
-------------------------
--------S----------------
-------------------------
-------------------------
-oo----E-EE--------------
-----------XX-X--SS------
-----------XX-X----------
-----------XX-X----------
-----------X--X----------
----X------X--X--XXXXXXXX