-----------------------------
-----------------------------
-----------------------------
-----------------------------
-----------------------------
--------------------SSSSSSSSS
-----------------------------
-----------------------------
---oo-------------SS---------
-----------------------------
-----------------------------
-----------------------------
-------E-EE-E----------------
X-----XXXXXXXX--XXXXX--------