------------------------------
------------------------------
------------------------------
------------------------------
------------------------------
---------SSS-----------SSSSSSS
------------------------------
-----oo------------oo---------
------------------------------
-XXX-----------XXX------------
-XXX-----------XXX------------
-XXX-----------XXX------------
-XXX-----------XXX------------
-XX---XXXXX-X--XX---XXXXX-----