------------------------------
------------------------------
------------------------------
------------------------------
------------------------------
----SSSSSSSS-----SS-------XXX-
--------------------------XXX-
------------------------X-XXX-
---------------SS-------X-XXX-
----------------------X-X-XXX-
----------------------X-X-XXX-
----------------------X-X-XXX-
----------------------X-X-XXX-
XXXXXX-------XXXXX-X--X-X-XXXX