------------------------------
------------------------------
------------------------------
------------------------------
------------------------------
------------------------------
------------------------------
------------------------------
-------------o----------------
----<>------------------------
----[]------------------------
----[]------------------------
--E-[]------------------------
-XXXXXXXXXX------XX--XXX-----X