-----------------------------
-----------------------------
-----------------------------
-----------------------------
-----------------------------
-----------------------------
-----------------------------
----------o------------------
-----------------------------
--------SS-------------------
----------------E--------E-E-
---------------<>----B--<><><
----EE---------[]----b--[][][
XXXXXXXXXXXXXXXXXXXXXXXXXXXXX