------------------------------
------------------------------
------------------------------
------------------------------
------------------------------
--S---------S-----------------
--------------------------oo--
------------------------------
-E-EE------E-EE---------E-----
-----XX-X------XX-X----<>-----
-----XX-X------XX-X----[]-----
-----XX-X------XX-X----[]-----
-----X--X------X--X----[]-----
-----X--X------X--X--XXXXXXXXX