------------------------------
------------------------------
------------------------------
------------------------------
------------------------------
---------SSSS--------SSSSSSSSS
------------------------------
-----oo-----------o-----------
------------------------------
-XXX------------SS------------
-XXX--------------------------
-XXX--------------------------
-XXX--------------------------
-XX---XXXXX---XXXXXXXXX-------