------------------------------
------------------------------
------------------------------
------------------------------
------------------------------
----------------S----------S--
------------------------------
------------------------------
---------------E-EE-------E-EE
-----------XX------XX-XX------
----------XXX------XX-XX------
---------XXXX------XX-XX------
--XX----XXXXX------X--XX------
XXXXXXXXXXXXX------X--XX------