------------------------------
------------------------------
------------------------------
------------------------------
------------------------------
SSSS------S-------SSSS-------X
-----------------------------X
---------------------------X-X
SSSS-----E-EE--------------X-X
-------------XX-XX-------X-X-X
-------------XX-XX-------X-X-X
-------------XX-XXX------X-X-X
-------------X--XXX------X-X-X
----XX-------X--XXXXX-X--X-X-X