------------------------------
------------------------------
------------------------------
------------------------------
------------------------------
SSSSS-----SSSSSSS-----S-------
------------------------------
------------------------------
SSSSS----------------E-EE-----
-------------------------XX-X-
-------------------------XX-X-
-------------------------XX-X-
-------------------------X--X-
-----XX-XXXX------X------X--X-