------------------------------
------------------------------
------------------------------
------------------------------
------------------------------
--S-------SSSSS---------S-----
------------------------------
------------------------------
-E-EE------------------E-EE---
-----XX-XX----------X------XX-
-----XX-XX----------X------XX-
-----XX-XXX-------X-X------XX-
-----X--XXX-------X-X------X--
-----X--XXXXX---X-X-X------X--