------------------------------
------------------------------
------------------------------
------------------------------
------------------------------
SS--------S---------S-------SS
------------------------------
------------------------------
SS-------E-EE------E-EE-------
-------------XX-X------XX-XX--
-------------XX-X------XX-XX--
-------------XX-X------XX-XXX-
----X--------X--X------X--XXX-
--XXXXX------X--X------X--XXXX