------------------------------
------------------------------
------------------------------
------------------------------
------------------------------
----------------XX--SSSSSSSSS-
----------------XX------------
--------------X-XX------------
---------o----X-XX------------
---X--X-----X-X-XX------------
---X--X-----X-X-XX------------
---X--X-----X-X-XX------------
---X--X-----X-X-XX------------
---X--X-----X-X-XXXXXX--------