------------------------------
------------------------------
------------------------------
------------------------------
------------------------------
-----SS-----S-------SSSSS---SS
------------------------------
------------------------------
oo---SS----E-EE---------------
---------------XX-XX----------
---------------XX-XX---------E
---------------XX-XXX-------<>
---------------X--XXX-------[]
---X---XX------X--XXXXX---XXXX