------------------------------
------------------------------
------------------------------
------------------------------
------------------------------
SSS--SSS--SSSSSSS---SSSSSSSSS-
------------------------------
------------------------------
SSS---------------------------
---------X--------------------
---------X--------------------
---------X--------------------
---------X--------------------
---XXXXXXXXX------XXXX--------