------------------------------
------------------------------
------------------------------
------------------------------
------------------------------
------SSSSSSS---SSSSSSS-----S-
------------------------------
------------------------------
oo-------------------------E-E
------------------------------
------------------------------
------------------------------
------------------------------
---XXXXX------XXXX------X-----