------------------------------
------------------------------
------------------------------
------------------------------
------------------------------
--------S----------------S----
------------------------------
------------------------------
-oo----E-EE-------------E-EE--
-----------XX-X------X------XX
-----------XX-X------X------XX
-----------XX-X----X-X------XX
-----------X--X----X-X------X-
----X------X--X--X-X-X------X-