------------------------------
------------------------------
------------------------------
------------------------------
------------------------------
--------------SSSSSSSSSSSS----
------------------------------
---------o--------------------
o-----------------------------
-------SS---XX----------------
------------XX----------------
----B-------XXX---------------
----b-------XXX---------------
--XXXXXXXXXXXXXXX----------XXX