------------------------------
------------------------------
------------------------------
------------------------------
------------------------------
SSS----------SSSSS---SSSSSSSSS
------------------------------
----------X-------------------
SSS------XX-------------------
---------XX-------------------
-------XXXX-------------------
------XXXXX-------------------
---------XX-------------------
---XXXXXXXXXXXX----XXXX-------