------------------------------
------------------------------
------------------------------
------------------------------
------------------------------
-----------S-------SSSSSSS----
------------------------------
------------------------------
----------E-EE----------------
-------X------XX-XX-----------
--E----X------XX-XX-----------
-------X------XX-XXX----------
-------X------X--XXX----------
-X-XX--X------X--XXXXX-----X--