------------------------------
------------------------------
------------------------------
------------------------------
------------------------------
--S----------SSS--------------
------------------------------
------------------------------
-E-EE-------------------------
-----XX-X--XX-----------------
-----XX-X--XX--------------E--
-----XX-X--XXX----------------
-----X--X--XXX--E-E-----------
-----X--X--XXXXXXXXX-XXX--X-XX