------------------------------
------------------------------
------------------------------
------------------------------
------------------------------
--S---------S-----------------
------------------------------
------------------------------
-E-EE------E-EE---------------
-----XX-X------XX-X----X-----Q
-----XX-X------XX-X----XX-----
-----XX-X------XX-X----XXX----
-----X--X------X--X----XXXX---
-----X--X------X--X--XXXXXXXXX