------------------------------
------------------------------
------------------------------
------------------------------
------------------------------
---------SS------SSSSSSSS-----
----E-------------------------
---<>-------------------------
---[]----SS------------------E
---XXX------------------------
------------------------------
------------------------------
-------------EE---------------
--XXXXXX---XXXXXXXX-------X---