------------------------------
------------------------------
------------------------------
------------------------------
------------------------------
-------S---------S------------
------------------------------
------------------------------
------E-EE------E-EE----------
-SS-------XX-X------XX-X------
----------XX-X------XX-XX-----
----------XX-X------XX-XXX----
----------X--X------X--XXXX--X
-XXX------X--X------X--XXXXXXX