------------------------------
------------------------------
------------------------------
------------------------------
------------------------------
SSSS------SSSS---SSSSSSS---SSS
------------------------------
------------------------------
SSSS--------------------------
------------------------------
------------------------------
------------------------------
------------------------------
----XXX-XXXX---XXXX------XXXX-