------------------------------
------------------------------
------------------------------
------------------------------
------------------------------
--S---------------S-----------
------------------------------
------------------------------
-E-EE------------E-EE------o--
-----XX-X------------XX-X-----
-----XX-X------------XX-X-----
-----XX-X------------XX-X-----
-----X--X---EE-------X--X-----
-----X--X--XXXX------X--X-----