-------------------------
-------------------------
-------------------------
-------------------------
-------------------------
--S----------------------
-------------------------
-------------------------
-E-EE------o-------------
-----XX-X----------------
-----XX-X----------------
-----XX-X----------------
-----X--X---------E-E-EE-
-----X--X----XXXXXXXXXXXX