------------------------------
------------------------------
------------------------------
------------------------------
------------------------------
-------E-------S---------S----
------------------------------
---------X--------------------
-------EXX----E-EE------E-EE--
------<>XX--------XX-X------XX
------[]XX--------XX-X------XX
-----X[]XX--------XX-X------XX
----XX[]XX--------X--X------X-
XXXXXXXXXXXX------X--X------X-