------------------------------
------------------------------
------------------------------
------------------------------
------------------------------
--S---------------------------
------------------------------
------------------------------
-E-EE---------------------oo--
-----XX-X-------------S-------
-----XX-X---------------------
-----XX-X---------------------
-----X--X---EE-EE-------------
-----X--X--XXXXXXX--XXXXX----X