------------------------------
------------------------------
------------------------------
------------------------------
------------------------------
---------------SSSSSSSSSSSS---
------------------------------
----------o-------------------
---oo-------------------------
--------SS---XX---------------
-------------XX---------------
-------------XXX--------------
-------------XXX--------------
X-----X-XXXXXXXXXX----------XX