------------------------------
------------------------------
------------------------------
------------------------------
------------------------------
--------S----------------SSSSS
------------------------------
--E---------------------------
-<>----E-EE-------------------
-[]--------XX-X----XX---------
-[]--------XX-X----XX---------
-[]--------XX-X----XX---------
-[]--------X--X----XX---------
-XXXX------X--X--XXXX--XXXX---