---------------------------
---------------------------
---------------------------
---------------------------
---------------------------
---------------------------
-------------------------E-
------------------------<>-
-------------------o----[]-
---------X--------------XXX
---------X-----------------
---------X-----------------
---------X-----------------
---X-XX--X--X--XXX---X-XXXX