------------------------------
------------------------------
------------------------------
------------------------------
------------------------------
----SS-----S---------S--------
------------------------------
------------------------------
----------E-EE------E-EE------
-E-X----------XX-X------XX-X--
<>-X----------XX-X------XX-X--
[]-X----------XX-X------XX-X--
[]-X----------X--X------X--X--
XXXXXXXX------X--X------X--X--