------------------------
------------------------
------------------------
------------------------
------------------------
---------------------S--
------------------------
------------------------
-------o------------E-EE
------------------------
------------------------
------------------------
-------------E-EE-------
-X---X----XXXXXXXX------