------------------------------
------------------------------
------------------------------
------------------------------
------------------------------
--S----------------S---------S
------------------------------
------------------------------
-E-EE-------------E-EE------E-
-----XX-X--XX---------XX-X----
-----XX-X--XX---------XX-X----
-----XX-X--XXX--------XX-X----
-----X--X--XXX--------X--X----
-----X--X--XXXXX------X--X----