------------------------------
------------------------------
------------------------------
------------------------------
------------------------------
SSSSS--------S----------------
------------------------------
------------------------------
SSSSS-------E-EE-------------E
----------------XX-X--XX------
----------------XX-X--XX------
----------------XX-X--XXX-----
-------X--------X--X--XXX-----
-----XXXXX------X--X--XXXXX---