---------------------------
---------------------------
---------------------------
---------------------------
---------------------------
--------SSSSSSSSSSS--------
-------------------------E-
------------------------<>-
-----S------------------[]-
------------------------XX-
---------------------------
---------------------------
---------------------------
XXXXXXXXXX----------XXXXXXX