------------------------------
------------------------------
------------------------------
------------------------------
------------------------------
-----------S----------S-------
------------------------------
------------------------------
-oo-------E-EE-------E-EE-----
------S-------XX-X-------XX-X-
--------------XX-X-------XX-X-
--------------XX-X-------XX-X-
--------------X--X-------X--X-
----XXXX------X--X-------X--X-