------------------------------
------------------------------
------------------------------
------------------------------
------------------------------
SSSSSS---------------SSSSSSSSS
------------------------------
------------------------------
SSSSSS------------E-----------
-----------------<>-----------
-----------------[]-----------
--------------B--[]-----------
--------EE----b--[]-----------
------XXXXX-XXXXXXXXXXX-------