------------------------------
------------------------------
------------------------------
------------------------------
------------------------------
--S----------SSSSSS---SSSSSSSS
------------------------------
------------------------------
-E-EE-------------------------
-----XX-X---------------------
-----XX-X---------------------
-----XX-X---------------------
-----X--X---------------------
-----X--X--XXXX-----XXXX------