------------------------------
------------------------------
------------------------------
------------------------------
------------------------------
-----SSSSSS----------S--------
------------------------------
------------------------------
--S-----------o-----E-EE------
-----------------X------XX-X--
-----------------X------XX-X--
-----------------X------XX-X--
-----------------X------X--X--
XXXXXXX-----X----X------X--X--