------------------------------
------------------------------
------------------------------
------------------------------
------------------------------
SSS---------------S----------S
------------------------------
------------X-----------------
SSS--------XX----E-EE-------E-
-----------XX--------XX-X-----
---------XXXX--------XX-X-----
--------XXXXX--------XX-X-----
-----------XX--------X--X-----
---XXXXXXXXXXXX------X--X-----