------------------------------
------------------------------
------------------------------
------------------------------
------------------------------
--S----------SS-----S---------
------------------------------
------------------------------
-E-EE--------------E-EE-------
-----XX-X--------------XX-X---
-----XX-X--------------XX-X---
-----XX-X--------------XX-X---
-----X--X--------------X--X---
-----X--X--XXXXXX------X--X---