------------------------------
------------------------------
------------------------------
------------------------------
------------------------------
--S----------SSSSSS-----S-----
------------------------------
------------------------------
-E-EE------------------E-EE---
-----XX-XX-----------------XX-
-----XX-XX----E------------XX-
-----XX-XXX--<>------------XX-
-----X--XXX--[]------------X--
-----X--XXXXXXXXX---X------X--