------------------------------
------------------------------
------------------------------
------------------------------
------------------------------
--S-------SSSSSSS---SSSSSSSSSS
------------------------------
------------------------------
-E-EE-------------------------
-----XX-XX--------------------
-----XX-XX--------------------
-----XX-XXX-------------------
-----X--XXX-------------------
-----X--XXXXX-----XXXX--------