------------------------------
------------------------------
------------------------------
------------------------------
------------------------------
-----------SSSS-----S---------
------------------------------
------------------------------
--E------SS--------E-EE------E
-<>---X----------------XX-X---
-[]---X----------------XX-X---
-[]---X----------------XX-X---
-[]---X----------------X--X---
-XXXXXXXXXXX----X------X--X---