------------------------------
------------------------------
------------------------------
------------------------------
------------------------------
--------S-------SSSSSSS-----S-
------------------------------
---X--------------------------
---X---E-EE----------------E-E
-X-X-------XX-XX--------------
-X-X-------XX-XX--------------
-X-X-------XX-XXX-------------
-X-X-------X--XXX-------------
-X-X-------X--XXXXX-----X-----