------------------------------
------------------------------
------------------------------
------------------------------
------------------------------
---------S---------S----------
------------------------------
------------------------------
oo------E-EE------E-EE--------
------------XX-X------XX-X----
------------XX-X------XX-X----
------------XX-X------XX-X----
------------X--X------X--X----
-----X------X--X------X--X--X-