------------------------------
------------------------------
------------------------------
------------------------------
------------------------------
SSS-----------SSSSSSSSSS------
------------------------------
-----------------------------<
SSS------E--SS---------------[
--------<>-------------------X
--------[]--------------------
--------[]--------------------
--------[]--------------------
---XXXXXXXXXXXX----------XXXXX