------------------------------
------------------------------
------------------------------
------------------------------
------------------------------
-----SS------SSSSSSSSSS-----S-
------------------------------
------------------------------
oo---SS--------------------E-E
------------------------------
------------------------------
------------------------------
---------EE-------------------
---X---XXXXXXXX---------X-----