-----------------------------
-----------------------------
-----------------------------
-----------------------------
-----------------------------
SSSS-----S----------SSSSSSSSS
-----------------------------
-----------------------------
SSSS----E-EE-----------------
------------XX-X-------------
------------XX-X-------------
------------XX-X-------------
------------X--X-------------
----XX------X--X--XXXX-------