------------------------------
------------------------------
------------------------------
------------------------------
------------------------------
SSS-----S----------SSSSSSSSSSS
------------------------------
------------------------------
SSS----E-EE-------------------
-----------XX-X---------------
-----------XX-X---------------
-----------XX-X---------------
-----------X--X---------------
---XX------X--X--XXXX---------