------------------------------
------------------------------
------------------------------
------------------------------
------------------------------
--S-------SSSSSSSSSSS---------
------------------------------
----------------------------X-
-E-EE----------------------XX-
-----XX-XX-----------------XX-
-----XX-XX---------------XXXX-
-----XX-XXX-------------XXXXX-
-----X--XXX----------------XX-
-----X--XXXXX---------XXXXXXXX