----------------------------
----------------------------
----------------------------
----------------------------
----------------------------
SSS-----SSSSSSS---SSSSSSSSS-
----------------------------
----------------------------
SSS-------------------------
----------------------------
----------------------------
----------------------------
----------------------------
---XXXXXXX------XXXX--------