------------------------------
------------------------------
------------------------------
------------------------------
------------------------------
--------SSSSSSSSS---SSSSS---SS
------------------------------
------------------------------
------------------------------
-SS---------------------------
------------------------------
------------------------------
-----X------------------------
-XXXXXXXXX--------XXXX----XXXX