----------------------------
----------------------------
----------------------------
----------------------------
----------------------------
-----------S---------S------
----------------------------
----------------------------
oo--------E-EE------E-EE----
----X--X------XX-X------XX-X
----X--X------XX-X------XX-X
----X--X------XX-X------XX-X
----X--X------X--X------X--X
----X--X------X--X------X--X