------------------------------
------------------------------
------------------------------
------------------------------
------------------------------
------SSSSSS---SSSSSSSSSSS----
------------------------------
------------------------------
-o----------------------------
------------------------------
------------------------------
------------------------------
------------------------------
----XXXX-----XXXX----------XXX