------------------------------
------------------------------
------------------------------
------------------------------
------------------------------
SSSSSS-------S---------S------
------------------------------
------------------------------
SSSSSS------E-EE------E-EE----
----------------XX-X------XX-X
----------------XX-X------XX-X
----------------XX-X------XX-X
--------E-------X--X------X--X
------XXXX------X--X------X--X