------------------------------
------------------------------
------------------------------
------------------------------
------------------------------
--------S---------S----------S
------------------------------
---X--------------------------
---X---E-EE------E-EE-------E-
-X-X-------XX-X------XX-X-----
-X-X-------XX-X------XX-X-----
-X-X-------XX-X------XX-X-----
-X-X-------X--X------X--X-----
-X-X-------X--X------X--X-----