------------------------------
------------------------------
------------------------------
------------------------------
------------------------------
---------------------S--------
------------------------------
------------------------------
-oo---o-------o--o--E-EE------
----------XX------------XX-X--
----------XX------------XX-X--
----------XX------------XX-X--
----------XX------------X--X--
----X---XXXX------------X--X--