------------------------------
------------------------------
------------------------------
------------------------------
------------------------------
--S-------------SSSSSSSSSS----
------------------------------
------------------------------
-E-EE-------------------------
-----XX-X---------------------
-----XX-X---------------------
-----XX-X---------------------
-----X--X---EE----------------
-----X--X--XXXXXXX---------X--