---------------------------
---------------------------
---------------------------
---------------------------
---------------------------
---------------------------
---------------------------
---------------------------
--o---o--------------------
-----------<>------X-------
-----------[]------XX------
-----------[]------XXX-----
-----------[]------XXXX----
----XXXXXXXXXXXXX--XXXXXXXX