-----------------------------
-----------------------------
-----------------------------
-----------------------------
-----------------------------
--S------------S-------------
-----------------------------
-----------------------------
-E-EE------o--E-EE-------oo--
-----XX-X---------XX-X-------
-----XX-X---------XX-X-------
-----XX-X---------XX-X-------
-----X--X---------X--X-------
-----X--X---------X--X-------