------------------------------
------------------------------
------------------------------
------------------------------
------------------------------
--------------S------------S--
------------------------------
---X--------------------------
---X-----oo--E-EE------o--E-EE
-X-X-------------XX-X---------
-X-X-------------XX-X---------
-X-X-------------XX-X---------
-X-X-------------X--X---------
-X-X-------------X--X---------