------------------------------
------------------------------
------------------------------
------------------------------
------------------------------
----SSSSSS---SSSSSSSSSSS------
------------------------------
-----------------------------<
-----------------------------[
-----------------------------X
------------------------------
------------------------------
------------------------------
XXXXXX-----XXXX----------XXXXX