------------------------------
------------------------------
------------------------------
------------------------------
------------------------------
SSSS-----S----------SS-----S--
------------------------------
------------------------------
SSSS----E-EE--------SS----E-EE
------------XX-X--------------
------------XX-X--------------
------------XX-X--------------
------------X--X--------------
----XX------X--X--X---XX------