------------------------------
------------------------------
------------------------------
------------------------------
------------------------------
------SSSSSSSSSS------------SS
------------------------------
-----------------------X------
----SS----------------XX--SS--
----------------------XX------
--------------------XXXX------
-------------------XXXXX------
----------------------XX------
XXXXXXX----------XXXXXXXXXXXX-