------------------------------
------------------------------
------------------------------
------------------------------
------------------------------
----------------S-------------
------------------------------
------------------------------
------------o--E-EE-------oo--
---X--X--X---------XX-X-------
---X--X--X---------XX-X-------
---X--X--X---------XX-X-------
---X--X--X---------X--X-------
---X--X--X---------X--X-------