------------------------------
------------------------------
------------------------------
------------------------------
------------------------------
------SSSSSSSSSSS---SSSSSSSSSS
------------------------------
------------------------------
------------------------------
------------------------------
------------------------------
------------------------------
--XX--------------------------
XXXXXXXX----------XXXXXXXXXX--