------------------------------
------------------------------
------------------------------
------------------------------
------------------------------
-----SSSSSSSSSSS---SSSSSSSSSSS
------------------------------
------------------------------
------------------------------
------------------------------
------------------------------
------------------------------
------------------------------
XXXXXXX----------XXXXXXXXXX---